NO ./assets/new_textures/TECH_1E.PNG
SO ./assets/new_textures/CONCRETE_3C.PNG
EA ./assets/new_textures/CONCRETE_3C.PNG
WE ./assets/new_textures/CONCRETE_3C.PNG
DO ./assets/new_textures/DOOR_4A.PNG
HN ./assets/sprites/animation/

F 160,160,0
C 0,0,160

        1111111111111111111111111
        1000000000110000000000001
        1011000001110000000000001
        1001000000010000000000001
111111111011000001110000000000001
100000000011000001111111111111111
11110111111111011100000010001
11111111111111011101010010001
11000000110101011100000010001
100000000000000011000000W0001
10000000000000001101010010001
1100000111010101110101101000111
11110111 1110101 101111010001
11111111 1111111 111111111111