F 160,160,0
C 160,160,160

111111111
110000001
100000001111111
1000E0000000001
100000001111111
111111111