F 255,255,0
C 160,160,160

111111111
100000001
101100001111111
1000000W0000001
100100001111111
111111111